{
	"tileset" : "chemin.png",
	"terrain" : [
		[2, 2, 2, 2, 2, 2, 9, 10, 11,  2,  2,  2,  2,  2,  2, 2 , 2 , 2, 2, 2, 2, 2  ],
		[2, 2, 2, 2, 2, 2, 9, 10, 11,  2,  2,  2,  2,  2,  2, 2 , 2 , 2, 2, 2, 2 ,2],
		[2, 2, 2, 2, 2, 2, 9, 10, 11,  2,  2,  2,  2,  2,  2, 2 , 2 , 2, 2, 2, 2 ,2],
		[2, 2, 2, 2, 2, 2, 9, 10, 11,  2,  2,  2,  2,  2,  2, 2 , 2 , 2, 2, 2, 2 ,2],
		[2, 2, 2, 2, 2, 2, 9, 10, 11,  2,  2,  2,  2,  2,  2, 2 , 2 , 2, 2, 2, 2,2 ],
		[2, 2, 2, 2, 2, 2, 9, 10, 11,  2,  2,  2,  2,  2,  2, 2 , 2 , 2, 2, 2 ,2,2],
		[2, 2, 2, 2, 2, 2, 9, 10,  8,  6,  6,  6,  6,  6,  6,  6 , 6 , 6 , 6 , 6 , 10, 10],
		[2, 2, 2, 2, 2, 2, 9, 10, 10, 10, 10, 10, 10, 10, 10, 10, 10, 10, 10 , 10, 10 , 11],
		[2, 2, 2, 2, 2, 2, 9, 10, 12, 14, 14, 14, 14, 14, 14, 14, 14, 14,14,12 , 10, 11],
		[2, 2, 2, 2, 2, 2, 9, 10, 11,  2,  2,  2,  2,  2,  2, 2 , 2 , 2, 2, 9, 10, 11],
		[2, 2, 2, 2, 2, 2, 9, 10, 11,  2,  2,  2,  2,  2,  2, 2 , 2 , 2, 2, 9, 10, 11],
		[2, 2, 2, 2, 2, 2, 9, 10, 11,  2,  2,  2,  2,  2,  2, 2 , 2 , 2, 2, 9, 10, 11],
		[2, 2, 2, 2, 2, 2, 9, 10, 11,  2,  2,  2,  2,  2,  2, 2 , 2 , 2, 2, 9, 10, 11],
		[2, 2, 2, 2, 2, 2, 9, 10, 11,  2,  2,  2,  2,  2,  2, 2 , 2 , 2, 2, 9, 10, 11],
		[2, 2, 2, 2, 2, 2, 9, 10, 11,  2,  2,  2,  2,  2,  2, 2 , 2 , 2, 2, 9, 10, 11],
		[2, 2, 2, 2, 2, 2, 9, 10, 11,  2,  2,  2,  2,  2,  2, 2 , 2 , 2, 2, 9, 10, 11],
		[2, 2, 2, 2, 2, 2, 9, 10, 11,  2,  2,  2,  2,  2,  2, 2 , 2 , 2, 2, 9, 10, 11],
		[2, 2, 2, 2, 2, 2, 9, 10, 11,  2,  2,  2,  2,  2,  2, 2 , 2 , 2, 2, 9, 10, 11],
		[2, 2, 2, 2, 2, 2, 9, 10, 11,  2,  2,  2,  2,  2,  2, 2 , 2 , 2, 2, 9, 10, 11],
		[2, 2, 2, 2, 2, 2, 9, 10, 11,  2,  2,  2,  2,  2,  2, 2 , 2 , 2, 2, 9, 10, 11],
		[2, 2, 2, 2, 2, 2, 9, 10, 11,  2,  2,  2,  2,  2,  2, 2 , 2 , 2, 2, 9, 10, 11],
		[2, 2, 2, 2, 2, 2, 9, 10,  8,  6,  6,  6,  6,  6,  6,  6 , 6 , 6 , 6, 8, 10, 11 ],
		[2, 2, 2, 2, 2, 2, 9, 10, 10, 10, 10, 10, 10, 10, 10, 10, 10, 10, 10 , 8, 10, 11 ],
		[2, 2, 2, 2, 2, 2, 9, 10, 12, 14, 14, 14, 14, 14, 14, 14, 14, 14, 14, 14, 14, 14 ],
		[2, 2, 2, 2, 2, 2, 9, 10, 11,  2,  2,  2,  2,  2,  2, 2 , 2 , 2, 2, 2, 2, 2],
		[2, 2, 2, 2, 2, 2, 9, 10, 11,  2,  2,  2,  2,  2,  2, 2 , 2 , 2, 2, 2, 2, 2],
		[2, 2, 2, 2, 2, 2, 9, 10, 11,  2,  2,  2,  2,  2,  2, 2 , 2, 2, 2, 2, 2, 2],
		[2, 2, 2, 2, 2, 2, 9, 10, 11,  2,  2,  2,  2,  2,  2, 2 , 2 , 2, 2, 2, 2, 2 ],
		[2, 2, 2, 2, 2, 2, 9, 10, 11,  2,  2,  2,  2,  2,  2, 2 , 2, 2, 2, 2, 2, 2],
		[2, 2, 2, 2, 2, 2, 9, 10, 11,  2,  2,  2,  2,  2,  2, 2 , 2, 2, 2, 2, 2, 2 ]
	]
}
